20 20

####################
#.........P......P.#
#...PPP............#
#...............PP.#
#....P.............#
####..##############
#.....P......P.....#
#.....P............#
#P.........P.......#
#################..#
#..PP..........P...#
#..................#
#..P..............P#
########...#########
#P...P.#.......P...#
#..P.......#P....P.#
#######....#########
#..................#
#........C.........#
####################

f . 
s # 