20 20

####################
#........C.........#
#..................#
#....#########.....#
#....#########.....#
#....#########.P...#
#..P.#########.....#
#....#########..P..#
#..P.#########.....#
#....#########.P...#
#.P..#########.....#
#....#########..P..#
#...P#########.....#
#....#########.P...#
#.P..#########.....#
#...P.....P........#
#..................#
#..P.......P.......#
#........P.........#
####################

f . 
s # 