20 5

####################
#P...P...#..P..#..C#
####P#...#..#P.#...#
#P...#...P..#......#
####################

f . 
s # 