20 10

#.##################
#.........P.....P..#
#...P..............#
#........P.P...P...#
#...P.........P....#
#.....P..P.........#
#.............P....#
##################.#
#........C.........#
####################

f . 
s # 