20 20

####################
#.................P#
#..P....#.....######
#..P....#..........#
#..P....#..........#
#................P.#
##################.#
#..P......P...P....#
#.........P........#
#..................#
#.##################
#.........P.....P..#
#...P..............#
#........P.....P...#
##################.#
#..................#
#..................#
#..................#
#........C.........#
####################

f . 
s # 